OOOOOOOOOOOOOOOO
OOOOOOOOOOOOOOOO
OOOOOOOOOOOOOOOO
OOOXOOXXXXOOXOOO
OOOXOOOOOOOOXOOO
OOOXOOOOOOOOXOOO
OOOXXXXOOXXXXOOO
OOOXOOOOOOOOXOOO
OOOXOOOOOOOOXOOO
OOOXOOXXXXOOXOOO
OOOXOOOOOOOOXOOO
OOOXOOOOOOOOXOOO
OOOXXXXOOXXXXOOO
OOOOOOOOOOOOOOOO
OOOOOOOOOOOOOOOO
XXXXOOXXXXOOXXXX
3
0