OOOOOOOOOOOOOOOO
OOOOOOOOOOOOOOOO
OOOOOOOOOOOOOOOO
OOOOOOOXXOOOOOOO
OOOOOOOOOOOOOOOO
OOOOOOOOOOOOOOOO
OOOOOOXXXXOOOOOO
OOOOOOOOOOOOOOOO
OOOOOOOOOOOOOOOO
OOOOOXXXXXXOOOOO
OOOOOOOOOOOOOOOO
OOOOOOOOOOOOOOOO
OOOOXXXXXXXXOOOO
OOOOOOOOOOOOOOOO
OOOOOOOOOOOOOOOO
XXXXXXXOOXXXXXXX
1
1