OOOOOOOOOOOOOOOO
OOOOOOOOOOOOOOOO
OOOOOOOOOOOOOOOO
XXOOOOOOOOOOOOXX
OOOOOOOOOOOOOOOO
OOOOOOOOOOOOOOOO
XXXOOOOOOOOOOXXX
OOOOOOOOOOOOOOOO
OOOOOOOOOOOOOOOO
XXXXOOOOOOOOXXXX
OOOOOOOOOOOOOOOO
OOOOOOOOOOOOOOOO
XXXXXOOOOOOXXXXX
OOOOOOOOOOOOOOOO
OOOOOOOOOOOOOOOO
OOXXXXXXXXXXXXOO
4
1