OOOOOOOOOOOOOOOO
OOOOOOOOOOOOOOOO
OOOOOOOOOOOOOOOO
OOOXXXXXXXXXXXXX
OOOOOOOOOOOOOOOO
OOOOOOOOOOOOOOOO
XXXXXXXXXXXXXOOO
OOOOOOOOOOOOOOOO
OOOOOOOOOOOOOOOO
OOOXXXXXXXXXXXXX
OOOOOOOOOOOOOOOO
OOOOOOOOOOOOOOOO
XXXXXXXXXXXXXOOO
OOOOOOOOOOOOOOOO
OOOOOOOOOOOOOOOO
XXXXXXXOOXXXXXXX
0
2